111111111111111111111
1P01000000001C0100011
1000C11111001000000C1
1001110C1000101111111
10110000000000001E001
1000011111C1110011101
11C011C0000001C000001
111111111111111111111